13
6
P F F F F W W W W F F F F
W B F F F W W O W F W W W
F F F B F F F F W W F O F
F F W W F F F F F F F F F
F F O W F F F W B F W F F
W W W W F F F F F F W F F


//Does not encapsulate map with walls