23
19
W W W W W W W W W W W W W W W W W W W W W W W
W F F F F F F F F W F F F W F F F F F F F F W
W F F F F F F F F W F B F W F F F F F F F F W
W F F F F F F F F W F F F W F F F F F F F F W
W F F F F F F F F W W F W W F F F F F F F F W
W F F F F F W W W W W F W W W W F F F F F F W
W F F F F F W F F F F O F F F W F F F W W W W
W F F F F F W F F F F F F F F W F F F W O O W
W W W W W W W F F W W W W F W W F F F W F F W
W F F F F F F F F F F F F F W W F F F W F F W
W F F F F F W O F W W W W F W W W W W W F F W
W F B W W W W F F W W W W F F F F F F F F F W
W F F F F F F F F W W W W W W W W F W W F F W
W W W W W W W F F F F F W F F F F F W W F F W
W F F F F F W F B W O F W F W W W B F F F F W
W F F F F F W F F F F F W F W F W F F F F P W
W F F F F F W W W W F F W F W F W W W W W W W
W F F F F F W F F W F F F F W F F F F F F F W
W W W W W W W W W W W W W W W W W W W W W W W